1111111111E1111111111
100000000000000000001
101110000000000011101
101000000000000000101
101000000000000000101
100000000010000000001
100000000111000000001
E0000000111110000000E
100000000111000000001
100000000010000000001
101000000000000000101
101000000000000000101
101110000000000011101
100000000000000000001
1111111111E1111111111