1111111111111111111111111111111111111
1111111111111111111111111111111111111
1111111111111111111111111111111111111
1111111111111111111111111111111111111
1111100000000000000000000000000001111
1111100000000000000000000100010001111
1111100222222222222000001000000001111
1111100200000000002000001000100001111
1111100200000000002000000000000101111
1111100200111111002001111110001001111
1111100200111111002001111110100001111
1111100200111111002001111110000001111
1111100200111111002001111110001001111
1111100200111111002001111110000001111
1111100200111111002001111110100001111
1111100200111111002001111110000001111
1111100200111111002000111110001001111
1111100200111111000200011110000001111
1111100200111111100020001111111111111
1111100200000000010002000000000001111
1111100200000000010002000000000001111
1111100222222220001000222222200001111
1111100000000002000100000000020001111
1111100000000002000100000000020001111
1111111111111000200011111110020001111
1111100000111100020001111110020001111
1111101000111110002001111110020001111
1111100000111111002001111110020001111
1111100100111111002001111110020001111
1111100000111111002001111110020001111
1111101000111111002001111110020001111
1111100000111111002001111110020001111
1111100000111111002001111110020001111
111110010011111100200111111002222E111
1111100000000000002000000010000001111
1111100100000000002000000010000001111
1111100000000000002000000010000001111
111111111111111111E111111111111111111
1111111111111111111111111111111111111
1111111111111111111111111111111111111
1111111111111111111111111111111111111