1111111111111111111111111
1000000000000000000000001
1000000000000000000000001
1001111111100011111111001
1001111111100011111111001
1001111111100011111111001
1001111111100011111111001
1001111111100011111111001
1001111111100011111111001
1001111111100011111111001
1001111111100011111111001
1001111111100011111111001
1001111111100001111111001
1001111111110000111111111
1001111111111000000000001
1000000000011100000000001
1000000000001111111111001
1111111110000111111111001
1001111111000011111111001
1001111111100011111111001
1001111111100011111111001
1001111111100011111111001
1001111111100011111111001
1001111111100011111111001
1001111111100011111111001
1001111111100011111111001
100111111110001111111100E
1001111111100011111111001
1000000000000000000001001
1000000000000000000001001
111111111111E111111111111