111111111111111111111111111111111111111111111
111111111111111111111111111111111111111111111
111111111111111111111111111111111111111111111
1111111111111111111111E1111111111111111111111
111100000000000000000020001100000000001101111
111100000000000010000020000000000000111001111
111100111101100110000020000000100000000001111
111100011000000000002222200010100000000001111
111101001100001100000000000001000000010001111
111101000110011100100001000001000010010001111
111101100011000100100100001101111110010001111
111100110001100000111000000000000010010001111
111100111011100000001001000000000100010001111
111100100000000110001000000000111111010001111
111100100010000001110000000000100000000001111
111100100010001001100011000100000000011001111
111100000110011010000010001100000010010001111
111100100110000100000000001000000000000001111
111101100100000100000000010000011000111011111
111101100110000000111000010001110000001001111
111101100111111000001001111000000000000001111
111101100100110000000000000001000000100001111
111100100110010000000000010000001000000001111
111100000000010000011100010000000000000001111
111100002000000011100000000010000000020001111
111E2222200000110000000010000000000002222E111
111100002001000011000011100110000010020001111
111100000001011010000000000111111110000001111
111100101000000100000000000000000000010001111
111101000110001100001000000000000011101001111
111101100000000000001001000100000000000001111
111100000000001000100000000010000000000001111
111100110010010001100100000000000000000101111
111101001100000000000101000000000110110001111
111101000000100000000011001000010000000001111
111100000000000100000010000000010000100001111
111100110000110101100010000000011000110001111
111100001000010000100010000100000100010001111
111100000000100000000110011100000100010001111
111101000000100010000000000100001000010001111
111100001001011111000000000000001000000001111
111100000001000000002222200010000001000001111
111100000000011010000020000000000001000001111
111110010000100000010020001100000110001001111
111100000000001000000020000000000000000001111
1111111111111111111111E1111111111111111111111
111111111111111111111111111111111111111111111
111111111111111111111111111111111111111111111
111111111111111111111111111111111111111111111