111111111111111111111111111111111
110000000011111111111110000000011
101111110001111111111100011111101
10000001000011111111100001000000E
101110011100011111100011100111101
100010000010001111100010000010001
1010111110110001E1000110111110101
100010000010000000000010000010001
101110011100001000100000110011101
100000010000001000100000010000001
111111110000000000000000011111111
100000010000001000100000010000001
101110011000001000100001110011101
100010000010000000000010000010001
1010111110110001E1000110111110101
100010000010001111100010000010001
101110011100011111100011100111101
E00000010000111111111000010000001
101111110001111111111100011111101
110000000011111111111110000000011
111111111111111111111111111111111