11111111111111111111111111111
11111111111111111111111111111
11111111111111111111111111111
11111111111111E11111111111111
11110000000000000000000001111
11110000000000000000000001111
11110011000000000000011001111
11110011000001110000011001111
11110000000001110000000001111
11110000011000000011000001111
11110000011000000011000001111
11110000000111111100000001111
11110110000111111100001101111
11111110000000000000001111111
11111100000000000000000111111
11110000000000000000000001111
11110000000011111000000001111
11110011111111111111111001111
111E001111111111111111100E111
11110011111111111111111001111
11110000000011111000000001111
11110000000000000000000001111
11111100000000000000000111111
11111110000000000000001111111
11110110000111111100001101111
11110000000111111100000001111
11110000011000000011000001111
11110000011000000011000001111
11110000000001110000000001111
11110011000001110000011001111
11110011000000000000011001111
11110000000000000000000001111
11110000000000000000000001111
11111111111111E11111111111111
11111111111111111111111111111
11111111111111111111111111111
11111111111111111111111111111