11111111111111111111111111111
11111111111111111111111111111
11111111111111111111111111111
11111111111111E11111111111111
11110000000000200000000001111
11110000000000200000000001111
11110010000000200000001001111
11110110002222222220001101111
11110000020000000002000001111
11110000200000000000200001111
11110002000001110000020001111
11110002001000000010020001111
11110002000000000000020001111
11110000200111111100200001111
11111000200111111100200011111
11111000200000000000200011111
11110002200000000000220001111
11110020000000000000002001111
11110020000011111000002001111
11110020011111111111002001111
111E222001111111111100222E111
11110020011111111111002001111
11110020000011111000002001111
11110020000000000000002001111
11111002200000000000020011111
11111000200000000000200011111
11111000200111111100200011111
11110000200111111100200001111
11110002000100000100020001111
11110002001000000010020001111
11110002000001110000020001111
11110000200000000000200001111
11110000020000000002000001111
11110110002222222220001101111
11110010000000200000001001111
11110000000000200000000001111
11110000000000200000000001111
11111111111111E11111111111111
11111111111111111111111111111
11111111111111111111111111111
11111111111111111111111111111