1111111111111111111
1111111111111111111
1111111111111111111
1111111111111111111
1111000000000001111
1111000000000001111
1111000022200001111
1111000222220001111
1111002222222001111
1111002200022001111
1111002200022001111
1111002200022001111
1111002200022001111
1111002200022001111
1111002200022001111
1111002200022001111
1111002200022001111
1111002200022001111
1111002200022001111
1111002200022001111
1111002200022001111
1111002200022001111
1111002200022001111
1111002200022001111
1111002200022001111
1111002200022001111
1111002222222001111
1111000222220001111
1111000022200001111
1111000002000001111
111111111E111111111
1111111111111111111
1111111111111111111
1111111111111111111