11111111111111111111111111111
10000000000000000000000000001
10111111111010101111111111101
10000000001010100000000000101
10111111101010101111111110101
10000000101010101000000100101
10111110101010101111110110101
10000010101010101000010000101
11111010101010101111101011111
E000001010101010100001000010E
10111110101010101111110110101
10000000101010101000000100101
10111111101010101111111110101
10000000001010100000000000101
10111111111010101111111111101
10000000000000000000000000001
11111111111111111111111111111