1111111111111111111111E11111111
1000000000001110000000000000001
1011110001111011110001111001101
1000010001000000010001000000101
1011011101111111110111011111101
1000000000000000000000000000001
1011111111110111111111111111101
E000000000000100000000000000001
1011111111110111111111111111101
1000000000000000000000000000001
1011011101111111110111011111101
1000010001000000010001000000101
1011110001111011110001111001101
1000000000001110000000000000001
1111111111111111111111111111111