               1
              111
             11111
            1111111
           1111E1111
          11110201111
         1110002000111
        111100020001111
       11110000200001111
      1111000022000001111
     111100002200000001111
    11110000220000000001111
   1111000022000000000001111
  111100022000000000000001111
  111100022000000000000001111
 11110000220011111000000001111
11110000022000FFF10000000001111
11110000022222FFF10000000001111
11110000022000FFF10000000001111
 11110000220011111000000001111
  111100022000000000000001111
  111100022000000000000001111
   1111000022000000000001111
    11110000220000000001111
     111100002200000001111
      1111000022000001111
       11110000200001111
        111100020001111
         1110002000111
          11110201111
           1111E1111
            1111111
             11111
              111
               1
