               1
              111
             11111
            1111111
           1111E1111
          11110001111
         1111000001111
        111100000001111
       11110000000001111
      1111000000000001111
     111100000000000001111
    11110000000000000001111
   1111000000000000000001111
  111100000000000000000001111
 11110000000011111000000001111
11110000000000SSS10000000001111
11110000000000SSS10000000001111
11110000000000SSS10000000001111
 11110000000011111000000001111
  111100000000000000000001111
   1111000000000000000001111
    11110000000000000001111
     111100000000000001111
      1111000000000001111
       11110000000001111
        111100000001111
         1111000001111
          11110001111
           1111E1111
            1111111
             11111
              111
               1
