          11E11
         1100011
        110000011
       11000000011
      1100000000011
     110000000000011
    11000000000000011
   1100000000000000011
  110000000000000000011
 11000000000000000000011
1100000000111110000000011
10000000000SSS10000000001
10000000000SSS10000000001
10000000000SSS10000000001
1100000000111110000000011
 11000000000000000000011
  110000000000000000011
   1100000000000000011
    11000000000000011
     110000000000011
      1100000000011
       11000000011
        110000011
         1100011
          11E11
