1111111111111111111111111111111111111111111
1111111111111111111111111111111111111111111
1111111111111111111111111111111111111111111
1111111111111111111111111111111111111111111
1111000000000000000000000000000000000001111
1111000111111110000000000001111111100001111
1111000000000000000222220000000000000001111
1111000000000000000200020000000000000001111
111E22222222222222220P02222222222222222E111
1111000000000000000200020000000000000001111
1111000000000000000222220000000000000001111
1111000111111110000000000001111111100001111
1111000000000000000000000000000000000001111
1111111111111111111111111111111111111111111
1111111111111111111111111111111111111111111
1111111111111111111111111111111111111111111
1111111111111111111111111111111111111111111
