1111111111111111111111111111111111111
1000000000000000000000000000000000001
1000000000000000000000000000000000001
1000000000001101111111111000000000001
1000000000001000000000001000000000001
E00000000000100000P00000100000000000E
1000000000001000000000001000000000001
1000000000001111111111011000000000001
1000000000000000000000000000000000001
1000000000000000000000000000000000001
1111111111111111111111111111111111111