1111111E11111
1000001000001
1011101001101
1000100001001
1010111110101
1000100001001
E000001101111
1000100001001
1010111110101
1000100001001
1011101001101
1000001000001
1111111E11111