1111111111111111111111111111111
1111111111111111111111111111111
1111111111111111111111111111111
111111111111111E111111111111111
1111000000001100011000000001111
1111000000001100011000000001111
1111001110001100011000111001111
1111001110001100011000111001111
1111001110001100011000111001111
1111001110001100011000111001111
1111001110001100011000111001111
1111001110001100011000111001111
1111001110001100011000111001111
1111001110001100011000111001111
1111001110001100011000111001111
111E00111000110001100011100E111
1111001110001100011000111001111
1111001110001100011000111001111
1111001110001100011000111001111
1111001110001100011000111001111
1111001110001100011000111001111
1111001110001100011000111001111
1111001110001100011000111001111
1111001110001100011000111001111
1111001110001100011000111001111
1111001110000000000000111001111
1111001110000000000000111001111
1111111111111111111111111111111
1111111111111111111111111111111
1111111111111111111111111111111
1111111111111111111111111111111