1111111111111111111111111111111111111111111111111
1111111111111111111111111111111111111111111111111
1111111111111111111111111111111111111111111111111
111111111111111111111111E111111111111111111111111
1111000000000000000011002001100000000000000001111
1111000000000000000011002001100000000000000001111
1111000222222222220011002001100222222222220001111
1111000220000000220011002001100220000000220001111
1111000220000000220011002001100220000000220001111
1111000220011100220011002001100220011100220001111
1111000020011100220011002001100220011100200001111
1111000020011100220011002001100220011100200001111
1111000020011100220011002001100220011100200001111
1111000020011100220011002001100220011100200001111
1111000020011100220011002001100220011100200001111
1111000020011100220011002001100220011100200001111
1111000020011100220011002001100220011100200001111
1111000020011100220011002001100220011100200001111
111E22222001110022001100200110022001110022222E111
1111000000011100220011002001100220011100000001111
1111000000011100220011002001100220011100000001111
1111000000011100220011002001100220011100000001111
1111000000011100220011002001100220011100000001111
1111000000011100220011002001100220011100000001111
1111000000011100220011002001100220011100000001111
1111000000011100220011002001100220011100000001111
1111000000011100220011002001100220011100000001111
1111000000011100220011002001100220011100000001111
1111000000011100220000002000000220011100000001111
1111000000011100220000002000000220011100000001111
1111000000011100222222222222222220011100000001111
1111000000011100000000000000000000011100000001111
1111000000011100000000000000000000011100000001111
1111111111111111111111111111111111111111111111111
1111111111111111111111111111111111111111111111111
1111111111111111111111111111111111111111111111111
1111111111111111111111111111111111111111111111111