111111111111111111111111111111111
111111111111111111111111111111111
111111111111111111111111111111111
111111111111111111111111111111111
111100000000110000000000000001111
111100011000110001100001100001111
111100011000000001111001100001111
111100000000000000000000011001111
111100000110001100000000011001111
111100000110001100001100000001111
111100000000000000000000000001111
111100110000110000000000000001111
111100110000000000011000011001111
111100000100000010011000011001111
111100110100110010000011000011111
111100000000110000000011000011111
111110000000000001100000000001111
111100020010000001100000020001111                                           1
111E2222001000110000001002222E111
111100020010000100011010020001111
111101000010100000011010000001111
111100000000000100000001000101111
111101110000001100011001111101111
111101111000000000010001111101111
111100011011000000000000001101111
111100000011011000000100001111111
111101100000011000000110000111111
111101100011000110000000110001111
111100011011000000000000110001111
111100011001000222001100000001111
111100001101000020001100001101111
111100001100000020010000001101111
111100000000010020011000000001111
1111111111111111E1111111111111111
111111111111111111111111111111111
111111111111111111111111111111111
111111111111111111111111111111111