111111111111111111111111111111111
111111111111111111111111111111111
111111111111111111111111111111111
111111111111111111111111111111111
111100000000110000000000000001111
111100011000110001100001100001111
111100011000000001111001100001111
111100000000000000000000011001111
111100000110001100000000011001111
111100000110001100001100000001111
111100000000000000000000000001111
111100110000110000000000000001111
111100110000000000011000011001111
111100000100000010011000011001111
111100110100110010000011000011111
111100000000110000000011000001111
111101000000000001100000000101111
111100020100000001100000020001111                                           1
111E2222010000110000001102222E111
111100020100000100011011020001111
111101000100100000011011000001111
111100000000000100000001000101111
111101110000001100011001111101111
111101111000000000010001111101111
111100011011000000000000001101111
111100000011011000000100001111111
111101100000011000000110000111111
111101100011000110000000110001111
111100011011000000000000110001111
111100011000100222001100000001111
111100001100100020001100001101111
111100001100000020100000001101111
111100000000011020110000000001111
1111111111111111E1111111111111111
111111111111111111111111111111111
111111111111111111111111111111111
111111111111111111111111111111111