1111111111111111111E11111
1000000000000000000000001
1000000000000000000000001
1000111000000000001110001
1000111000011100001110001
1000111000011100001110001
1000111000011100001110001
1000111000000000001110001
1000000000000000000000001
1000000000000000000000001
11111E1111111111111111111