1111111111111111111111111
1000000000000000000000001
1001110111000001110111001
1001000001000001000001001
1001000001000001000001001
1001110111000001110111001
1000011100000000011100001
1000001000000000001000001
1000000000000000000000001
111111111111E111111111111