1111111111111
1000000000001
100P00000000E
1000000000001
1000000000001
1000000000001
1000000000001
1000000000001
1000000000001
1000000000001
111E111111111