1111111111111111111111111
1000000000000000000000101
1011111111111111111111101
1000000000001000000000001
E00111111110101111111110E
1001000000000000000000101
1001111111111111111111101
1001000000000000000000001
1111111111111111111111111