11111E1111111111111111111
1000000000000010000000001
1000000000000010000000001
1000000110000010001111001
1000000110000010001000001
1000000000000010001001111
100000000000001000100100E
1110000001100000001000001
1000000001100010001111111
1000000000000010000000001
11111E1111111111111111111