11111111
10000001
10000001
100SS001
100SS001
10000001
10000001
111E1111