1111111111111111111111111111111111111111111111111
1000000000000000000000000000000000000000000000001
1000000000000000000000000000000000000000000000001
E00000000000000000000000000000000000000000000000E
1000000000000000000000000000000000000000000000001
1000000000000000000000000000000000000000000000001
1111111111000001111111111111111111111111111111111
         1000001
         1000001
         1000001
         1000001
         1000001
         1000001
         1000001
         1000001
         1000001
         1000001
         1000001
         1000001
         1000001
         1000001
         1000001
         1000001
         1000001
         111E111