111111
100001
E000011
10000011
110000011
 110000011
  110000011
   110000011
    110000011
     110000011
      110000011
       110000011
        110000011
         110000011
          110000011
           110000011
            110000011
             110000011
              110000011
               110000011
                110000011
                 11000001
                  1100001
                   110001
                    11E11