11111111111111111111E1111
1000000000110000000000001
1000000001110000000000001
100000000000000000000000111111111
111111111011000001110000000000001
100000000011000001110111101111111
11110111111111011100000010001
11110111111111011101010010001
110000001101010110000000100011111
100000000000000011000000100010001
E00000000000000011010100100000001
110000011101010111110111100010001
11110111 1110101 1011110100011111
11111111 1111111 111111111111