11111E11111
10000000001
10000000001
10001110001
10001110001
10001110001
10001110001
10001110001
10001110001
10001110001
10001110001
10000000001
10000000001
11111E11111