1111111111111
1000000000001
1001110111001
1001000001001
1001000001001
1001110111001
1000011100001
1000001000001
1000000000001
111111E111111