11111 111              111111111
10001 10111            10000000111
10001 100011           11000000001
11101 100001            1000000001
  1011100001            1000000011
  100000000111111       100000111
11100000000000001     1110000011
11100000000000001     10000000011
10000000000000001111110000000000111
11000001110000000000000000000000001
 1000001 10000000000000000000000001
 1000001110000001111111111111100001
 1000000000000001            111001
11000000000111101              1001
100000000001  101              1001
100000000001  101              1001
111111111101  101               101
         101  101               101
         1E1  111               101
                               1101
                               1001
                               1001
11111111111111111111111111111111001
10000000000000000000000000000000001
E0000000000000000000000000000000001
11111111111111111111111001110000001
                      1111 11111111