11111E11111
10000000001
10000111101
10000100001
10011101111
1000010100E
10000100001
11100111111
10000000001
10000000001
11111E11111