11111111111111111111111111111111111111111111111111
11111111111111111111111111111111111111111111111111
11111111111111111111111111111111111111111111111111
11111111111111111111111111111111111111111111111111
11110000000000000000000000000000000000000000001111
11110000000000000000000000000000000000000111101111
11110000000000000000000000000000000000000000101111
11110000000000000000000000000000000000000000101111
11110000000000000000000000000000000000000000101111
11110000000000000000000000000000000000000000001111
11110000000001110000000000000000000000000000001111
11110000000000000000000000000000000000000000001111
11110000000000000000000000000000000000000000001111
11110000000000000000001010000000000000000000001111
11110000000000000000000000000000000000000000001111
111100000000000P0000000000000000000000000000001111
11110000000000000000001001000000000000000000001111
11110000000000000000000000000000000000000000001111
11110000000000000000000000000000000000000000001111
11110000000000000100000000010001000000000000001111
11110000000000000000000000000000000000000000001111
11110000000000000000000000000001000000000000001111
11110000000000000000000000000001100000000000001111
11110000000000000000000000001000000000000000001111
11110000000000000000000000011000000000000000001111
11110000000000010000000000000000000000000000001111
11110000000000010000000000000000000000000000001111
11110000000000010000000000000000000000000000001111
11110000000000000000000000000111000000000000001111
11110000000000000000000000000000000000000000001111
11110000000000000000000000000000000000000000001111
11110100000000000000000000000000000000000000001111
11110100000000000000000000000000000000000000001111
11110100000000000000000000000000000000000000001111
11110111100000000000000000000000000000000000001111
11110000000000000000000000000000000000000000001111
11111111111111111111111111111111111111111111111111
11111111111111111111111111111111111111111111111111
11111111111111111111111111111111111111111111111111
11111111111111111111111111111111111111111111111111