11111111111111111111111111111111111111111111
10000000000000000000000000000000000000000001
10000000000000000000000000000000000000111101
10000000000000000000000000000000000000000101
10000000000000000000000000000000000000000101
10000000000000000000000000000000000000000101
10000000000000000000000000000000000000000001
10000000001110000000000000000000000000000001
10022200000000000000000000000000000000000001
10000200000000000000000000000000000000000001
10000200000000000001010000000000000000000001
10000200000000000000000000000000000000000001
100002000000P0000000000000000000000000000001
10000200000000000001001000000000000000000001
10000222200000000000000000000000000000000001
10002200000000000000000000000000000000000001
10000200000000100000000010001000000000000001
10000200000000000000000000000000000000000001
10000200000000000000000000001000000000000001
10000200000000000000000000001100000000000001
10000200000000000000000001000000000000000001
10000200000000000000000011000000000000000001
10000200000010000000000000000000000000000001
10000200000010000000000000000000000000000001
10000020000010000000000000000000000000000001
10000000000000000000000000111000000000000001
10000000000000000000000000000000000000000001
10000000000000000000000000000000000000000001
10100000000000000000000000000000000000000001
10100000000000000000000000000000000000000001
10100000000000000000000000000000000000000001
10111100000000000000000000000000000000000001
10000000000000000000000000000000000000000001
11111111111111111111111111111111111111111111