11111111111111111111111111111111111111111111
10000000000000000000000000000000000000000001
10000000000000000000000000000000000000000001
10000000000000000000000000000000000000000001
10000000000000000000000000000000000000000001
10000000000000000000000000000000000000000001
10000000000000000000000000000000000000000001
10000000003330000000000000000000000000000001
10033300000000000000000000000000000000000001
10000300000000000000000000000000000000000001
10000300000000000003030000000000000000000001
10000300000000000000000000000000000000000001
100003000000P0000000000000000000000000000001
10000300000000000003003000000000000000000001
10000333300000000000000000000000000000000001
10003300000000000000000000000000000000000001
10000300000000000000000000000000000000000001
10000300000000000000000000000000000000000001
10000300000000000000000000000000000000000001
10000300000000000000000000000000000000000001
10000300000000000000000000000000000000000001
10000300000000000000000000000000000000000001
10000300000000000000000000000000000000000001
10000300000000000000000000000000000000000001
10000030000000000000000000000000000000000001
10000000000000000000000000000000000000000001
10000000000000000000000000000000000000000001
10000000000000000000000000000000000000000001
10000000000000000000000000000000000000000001
10000000000000000000000000000000000000000001
10000000000000000000000000000000000000000001
10000000000000000000000000000000000000000001
10000000000000000000000000000000000000000001
11111111111111111111111111111111111111111111